* *******
* **  ***
*     ***
***** ***
*****   *
***** ***