* ***** *
* ***   *
*     ***
***** ***
*****   *
*********